1111111111111111111111111111
1000100XC100010CCC010CCC01E1
101000000101C10000X1X000X101
1011111111011110111100000101
1P000000000X001C00X000011101
111111101111111110000100X001
10X0C0100010CCC0101111011101
1C00100010000000X000010CCC01
1111111111111111111111111111