1111111111111111111111111111
1E0000C00010C0000C0000001001
1011111101111011111011101101
10C00000010000C000010C000101
1011011111011111011011111101
10C0100000000C0P000000C00001
1011111111111011111111110101
1000C00000C0000C0000C00000C1
1111111111111111111111111111