1111111111111111111111111111
1E00X0C00010C0X00C0X00001001
1011111101111011111011101101
10C0X000010000C0X0010C0X0101
1011011111011111011011111101
10C010X0000X0C0P0000X0C00001
1011111111111011111111110101
1000C0X000C0X00C0X00C0X000C1
1111111111111111111111111111