11111111111111111111
100011100011C10001E1
10101000100001010101
10111011110111010001
10X000000101C0011111
111110110101110001C1
1P00001C010000010001
11111111111111111111
