1111111111111111111111111111111111
1E0000000000000C00000C001000000001
1010010100100000101001001000010101
1010010010101010001001001000010101
1P0000000C00C000000000001000000001
1111111111111111111111111111111111
